1111111
1CEP001
1X00001
1111111
