1111111
1C0P101
10X01E1
1111111
