11111111111111111111111111111111111111111111111111111111111111111111111111111
10C0000000000XXXXX000000000000000000000000000000000000P00000000000000000000E1
11111111111111111111111111111111111111111111111111111111111111111111111111111
