11111111111111111111111
11111100011100111111101
11111000001000001110001
11111000000000000100001
111111000E0000000100001
11111111111100000000001
1000000C000000000000001
10000000000000000000001
10000000000000000000C01
11000000000C00000000001
11P10000000000000000011
11111111111111111111111
