1111111111111111111111
1000C00001110011111111
1000C00000100000111001
1000C00000000000010001
100000000E00000C010001
11000000000C000C00a001
110100000000000C0000P1
1111111111111111111111
