11111111111111111111111111
11111100011100111111100001
11111000001000001110000001
11111000000000000100000001
11111100000000000100000001
11111111111100000000000001
1000000C000000000000000001
10000000000000000000000001
10000000000000000000C00001
11000000000C00000000111101
11P100000000000000001C1111
11111111111111111111111111
