11111111111111111111111111
11111100011100111111100001
11111000001000001110000001
11111000000000000100000001
111111000E0000000100000001
11111111111100000000000001
10000000000000000000000001
10000000000000000000000001
10000000000000000000000001
11P00000000000000000111101
11P10000000000000000101111
11111111111111111111111111
