1111111111111111
1E000X0000000001
1111111111111101
100000X000000001
1011111111111111
100000X000000001
1111111111111101
100000X000000001
1011111111111111
100000X000000CP1
1111111111111111
