111111111111
100000001101
100000E01001
10000000C101
10000P00C101
111111111111
