1111111111111111111111111111
1000000001110011111110000001
1000000000100000111000000001
100000000000000001000000C001
100000000E000000010000000001
1000000000000000000000000001
1000000C0000000P000000000001
1000000000000000000000000001
10000000000000000000C0000001
11000000000C0000000000000001
11010000000X0000000000000001
1111111111111111111111111111
