111111111111
100000001101
100000E01001
100000P0C101
10000000C101
111111111111
