1111111111111111
11111110E0111111
11111111C1111111
11111110X0111111
11111111C1111111
11111110X0111111
11111111C1111111
11111110X0111111
11111111C1111111
11111110X0111111
11111111P1111111
1111111111111111
