11111111111
100000000X1
10000000001
10000CEP001
11111111111
