111111111111
1X0000001101
100000E01001
100000P0C101
10X00000C101
111111111111
