1111111111111111111111
100XC00001110011111111
1000C00000100000111001
1000C00000000000010001
1000X0000E000000010001
11000000000C0000000001
11010000000X00000000P1
1111111111111111111111
