111111111111111111111111
1E0111111111100000111111
1000X1111110000000001111
10000000C100000000000011
10X00000C100001100000001
1C0000000000001111100001
111111111111111111110001
1X0000001100000000000001
1C0000000000000000000001
1C0000001100000000000001
1CX0001111000000000000P1
111111111111111111111111
